110
#######################
.......................
###.#.#####.#####.#.###
  #.#......P......#.#  
###.#.#####.#####.#.###
#...#.....#.#.....#...#
#.#######.#.#.#######.#
#....#...........#....#
#.##...##.#.#.##...##.#
#.####.##.#.#.##.####.#
#......#..#.#..#......#
###.#####.....#####.###
###....##.#.#.##....###
#...#.....#.#.....#...#
#.#######.#.#.#######.#
#.....#...#.#...#.....#
###.#...###.###...#.###
  #.###.###.###.###.#  
  #...#.........#...#  
###.#.#.###.###.#.#.###
........#.....#........
#######################