#######################
#........#...#........#
#.####.#.#.#.#.#.####.#
#......#...#...#......#
#.####.###.#.###.####.#
#.#........#........#.#
#.#.###.#######.###.#.#
...........P...........
#.####.#.##.##.#.####.#
#.####.#.#...#.#.####.#
#......#.#...#.#......#
#.####.#.#####.#.####.#
#....#.#.......#.#....#
####.#.#.#####.#.#.####
.....#.....#.....#.....
#.####.###.#.###.####.#
#......#.......#......#
#.#.####.#.#.#.####.#.#
#.#......#...#......#.#
#.######.#####.######.#
#.....................#
#######################

