100
########## # ##########
#........# # #........#
#.######.# # #.######.#
#........  #  ........#
###.####.#####.####.###
  #.#.............#.#  
  #.#.####   ####.#.#  
  #...           ...#  
### #.# ### ### #.# ###
    #.# #     # #.#    
#####.# ####### #.#####
    #.#         #.#    
### #.# ####### #.# ###
  #........P........#  
  #.###.#######.###.#  
  #...#....#....#...#  
#####.####.#.####.#####
#.....#.........#.....#
#.###.#.#######.#.###.#
#.......   #   .......#
########## # ##########
         # # #         