105
#####             #####
#...# ########### #...#
#.#.# #.........# #.#.#
#.#.###.#######.###.#.#
#.#........#........#.#
#.###.####.#.####.###.#
 ..........P.......... 
###.#.# ####### #.#.###
  #.#.#       #.#.#.#
###.#.# ### ### #.#.###
   ...  #     #  ...   
###.#.# ####### #.#.###
  #...#         #...#  
#####.# ####### #.#####
#.....................#
#.#####.#######.#####.#
#.#.................#.#
#.#.#.###########.#.#.#
 ...#.............#... 
#.########.#.########.#
#..........#..........#
#######################