105
#####             #####
#...###############...#
#.#.................#.#
#.#####.#######.#####.#
#.....................#
#.###.#.#######.#.###.#
#.....#....#....#.....#
#.###.####.#.####.###.#
 ...#.#         #.#... 
###.#.# ### ### #.#.###
  #.### #     # ###.#  
  #.    #     #    .#  
###.#.# ####### #.#.###
 ...#.#         #.#... 
#.###.#### # ####.###.#
#.....#....#....#.....#
#.###.#.#######.#.###.#
#.....................#
#.#####.#######.#####.#
#.#........P........#.#
#...###############...#
#####             #####