105
 ##################### 
 #...................#
 #.#.#####.#.#####.#.# 
 #.#.#.....#.....#.#.# 
##.#.#.#########.#.#.##
  ...             ...  
##.#.# #### #### #.#.##
#..#.# #       # #.#..#
#.##.# ######### #.##.#
#....#           #....#
#.##.# ######### #.##.#
#.##.      #      .##.#
#..........#..........#
##.#.#####.#.#####.#.##
 #.#.#.....P.....#.#.# 
##.#.#.#########.#.#.##
  ...#...........#...
##.#.#####.#.#####.#.##
 #.#.......#.......#.#
 #.####.#######.####.#
 #...................#
 #####################