100
#######################
#.....................#
#.####.#.#####.#.####.#
#....#.#...#...#.#....#
####.#.###.#.###.#.####
    ...#...P...#...    
####.###.#####.###.####
#....  #...#...#  ....#
#.#### ### # ### ####.#
#....#           #....#
####.### ## ## ###.####
#....    #   #    ....#
#.#.#### ##### ####.#.#
#.#.#             #.#.#
#.#.# ########### #.#.#
#...#   .......   #...#
###.####.#####.####.###
#.....................#
#.#.####.#####.####.#.#
#.#.####.#####.####.#.#
#.....................#
#######################