####################
#............#.....#
#........P...#...#.#
#............#...#.#
#............#...#.#
#............#####.#
#....#.............#
#....#.............#
#....####.......####
#.........###......#
#.......#.###......#
#.......#..........#
#..................#
#...........#......#
####################